The Black Ryder - All That We See
The Rolling Stones - As Tears Go By
The Rolling Stones - You Can't Always Get What You Want
The Who - Baba O'Riley
Three Dog Night - One Is The Lonliest Number
Ben Howard - Promise
Al Green - Love and Happiness
Ben Harper - Waiting on an Angel
George Michael - Faith
Jeff Buckley - Hallelujah
Joseph Arthur - My Home Is Your Head
Joshua Radin - Brand New Day
Massive Attack - Teardrop
Matthew Ryal - Follow The Leader
Otis Redding - Pain In My Heart
Peter Gabriel - My Body Is A Cage (Arcade Fire cover)
Procol Harum - Whiter Shade Of The Pale
Ray Charles - Georgia on My Mind
Rickie Lee Jones - On Saturday Afternoons in 1963
Snow Patrol - Open Your Eyes
The Prodigy - Stand Up
Steve Winwood - I'm Not Drowning
The Boomtown Rats - I Don't Like Mondays
The Chordettes - Mr. Sandman
The Themes - Reminds Me of You
Yppah - Its Not The Same
Bread - Baby I'm A Want You
Funkadelic - Maggot Brain
Bill Callahan - Night
Black Lab - This Night
Damien Jurado - Everything Trying
Damien Rice - Delicate
Daniel Lanois - Fire
Dave Matthews - Some Devil
Goldfrapp - Crystalline Green
Hot Hot Heat - Let Me in
Iron and Wine - Passing Afternoon
Ohio Players - Love Rollercoaster
White Denim - I Start to Run (Season 7)
The Rolling Stones - Waiting on a Firend (Season 4)
Vibrolux - Spread Your Love (Season 5)
Jude - The Way That You Want Me (Season 6)
Amos Lee with Norah Jones - Colors (Season 2)
Badly Drawn Boy - The Shining (Season 5)
Hanson - Mmmbop (Season 5)
James Hunter - No Smoke Without Fire (Season 6)
Korn - Word Up (Season 2)
Mens Without Hats - The Safety Dance (Season 6)
Morgan Taylor Reid - Simply Human (Season 8)
My Morning Jacket - One Big Holiday (Season 4)
My Morning Jacket - Victory Dance (Season 7)
People In Planes - Light For The Deadvine (Season 4) 
Pete Yorn - Lose You (Season 5)
Ray Charles - Drown In My Own Tears (Season 5)
S. Carey - In The Dirt (Season 7)
Schuyler Fisk & Dave Bassett - Waking Life (Season 8)
The Cadillac Black - Down to The River (Season 8)
Awolnation - Sail (House MD Season 8 promo)
AC/DC - Highway To Hell (Season 3)
Radiohead - No Surprises (Season 6)
LUDO - Love Me Dead (Season 5)
Alanis Morissette - Not As We (Season 4)
Diana Ross & Supremes - You Keep Hangin' On (Season 4)
Christina Aguilera - Beautiful (Season 2)
Civil Twilight - Human (Season 4)
Jon Cleary - Got to Be More Careful (Season 5)
Mazzy Star - Into Dust (Season 3)
Dave Matthews - You Might Die Trying (Season 5)
Gomez - See the World (Season 3)
Pretenders - Lie to Me (Season 6)
Ryan Adams - Desire (Season 2)
Professor Longhair - Tipitina (Season 2)
Joe Cocker - Feeling Alright (Season 1)
Sly & The Family Stone - Life (Season 6)
Spoon - Got Nuffin (Season 7)